NO textures/north.xpm
SO textures/south.xpm
WE textures/west.xpm
EA textures/east.xpm
D textures/door.xpm

C 0,191,255
F 60,48,42

1111111111111111111111111
10E0030003000030003300001
1111111111111111111111111
