NO textures/north.xpm
SO textures/south.xpm
WE textures/west.xpm
EA textures/east.xpm

C 12,125,255
F 0,75,75

1111111111111111111111111
1000000000000000000100001
1001000000000S00000000001
1001000000000000001000001
1001000000000000001000001
1001000000100000001000001
1001000000000000001000001
1001000000001000001000001
1111111111111111111111111
