NO textures/north.xpm
SO textures/south.xpm
WE textures/west.xpm
EA textures/east.xpm

C 0,191,255
F 60,48,42

1111111111111111111111111
1000000000000000000100001
1001000000000N00000000001
1001000000000000001000001
1001000000000000001000001
1001000000100000001000001
1001000000000000001000001
1001000000001000001000001
1111111111111111111111111
