NO textures/north.xpm
SO textures/south.xpm
WE textures/west.xpm
EA textures/east.xpm
D textures/door.xpm

C 0,191,255
F 60,48,42

1111111111111111111111111
1000000000000000001100001
1003000000000W00001000001
1000000020000000003000001
1000000000000000001000001
1000000000100000001000001
1001000000000000001000001
1001000000001000001000001
1111111111111111111111111
