NO textures/north.xpm
SO textures/south.xpm
WE textures/west.xpm
EA textures/east.xpm

C 0,191,255
F 60,48,42

11111
10S01
10001
10001
11111
